1111111111111111
1000C00110000001
100000000000E001
1000000110000P01
1111111111111111
