11111111111111111111111111111
100C0010010000000000000000001
100M00100100000000M0000000001
100P001M000CM0C00ME0000000001
100000000100000000M0000000001
10000010010000000000000000001
11111111111111111111111111111
