1111111111111111
1000C00110000001
100P00000000E001
1000000110000001
1111111111111111
11111111111111111
