11111111111111111111111111111
100C0010010000000000000000001
10000010010000000000000000001
100P0010000C00C000E0000000001
10000000010000000000000000001
10000010010000000000000000001
11111111111111111111111111111
