1111111111111111
100E000000000001
10P0C0M001010001
1000000000100001
1111111111111111
