11111111111111111111111111111
100C00!0010000000000000000001
100000!0010000000000000000001
100P00!0000C00C000E0000000001
10000000010000000000000000001
100000!0010000000000000000001
11011111111111111111111111111
